OOOOOOOOOOOOOOOOOOOOOOOOOOOOOOO
O#########OOOOOOOOOOOO########O
O#OOOOOOO#OOOOOOOOOOOOOOOOOOO#O
O#OOOOOOO#OOOOOOOOOOOOOOOOOOO#O
O#OOOOOOO#OOOOOOOOOOOOOOOOOOO#O
O#OOOOOOOOOOOOOOOOOOOOOOOOOOO#O
O#OOOOOOOOOOOOOOOOOOOOOOOOOOO#O
O#OOOOOOOOOOOOOOOOOOOOOOOOOOO#O
O#OOOOOOOOOOOOOOOOOOOOOOOOOOO#O
OOOOOOOOOOOOOOOOOOOOO#########O
OOOOOOOOOOOOOOOOOOOOOOOOOOOOOOO
OOOOOOOOOOOOOOOOOOOOOOOOOOOOOOO
O#########OOOOOOOOOOOOOOOOOOOOO
O#OOOOOOOOOOOOOOOOOOOOOOOOOOO#O
O#OOOOOOOOOOOOOOOOOOOOOOOOOOO#O
O#OOOOOOOOOOOOOOOOOOOOOOOOOOO#O
O#OOOOOOOOOOOOOOOOOOO#OOOOOOO#O
O#OOOOOOOOOOOOOOOOOOO#OOOOOOO#O
O#OOOOOOOOOOOOOOOOOOO#OOOOOOO#O
O########OOOOOOOOOOOO#########O
OOOOOOOOOOOOOOOOOOOOOOOOOOOOOOO