OOOOOOOOOOOOOOOOOOOOOOOOOOOOOOO
O########OOOOOOOOOOOOO########O
O#OOOOOOOOOOOOOOOO#OOOOOOOOOO#O
O#OOOOOOOOOOOOOOOO#OOOOOOOOOO#O
O#OOOOOOOOOO###O###OOOOOOOOOO#O
O#OOOOOOOOOO#OOOOOOOOOOOOOOOO#O
O#OOOOOOOOOO#OOOOOOOOOOOOOOOO#O
O#OOOOOOOOOO#OOOOOOOOOOOOOOOO#O
OOOOOOOOOOOOOOOOOOOOOOOOOOOOOOO
OOOOOOOOOOOOOOOOOOOOOOOOOOOOOOO
OOOOOOOOOOOOOOOOOOOOOOOOOOOOOOO
OOOOOOOOOOOOOOOOOOOOOOOOOOOOOOO
OOOOOOOOOOOOOOOOOOOOOOOOOOOOOOO
OOOOOOOOOOOOOOOOOOOOOOOOOOOOOOO
O#OOOOOOOOOO#OOOOOOOOOOOOOOOO#O
O#OOOOOOOOOO#OOOOOOOOOOOOOOOO#O
O#OOOOOOOOOO###O###OOOOOOOOOO#O
O#OOOOOOOOOOOOOOOO#OOOOOOOOOO#O
O#OOOOOOOOOOOOOOOO#OOOOOOOOOO#O
O########OOOOOOOOOOOOO########O
OOOOOOOOOOOOOOOOOOOOOOOOOOOOOOO