OOOOOOOOOOOOOOOOOOOOOOOOOOOOOOO
O########OOOOOOOOOOOOO########O
O#OOOOOOOOOOOOOOOOOOOOOOOOOOO#O
O#OOOOOOOOOOOOOOOOOOOOOOOOOOO#O
O#OOOOOOO#############OOOOOOO#O
O#OOOOOOOOOOOOOOOOOOOOOOOOOOO#O
O#OOOOOOOOOOOOOOOOOOOOOOOOOOO#O
O#OOOOOOOOOOOOOOOOOOOOOOOOOOO#O
O####OOOOOOOOOOOOOOOOOOOOO####O
OOOOOOOOOOOOOOOOOOOOOOOOOOOOOOO
OOOOOOOOOOOOOOOOOOOOOOOOOOOOOOO
OOOOOOOOOOOOOOOOOOOOOOOOOOOOOOO
OOOOOOOOOOOOOOOOOOOOOOOOOOOOOOO
O####OOOOOOOOOOOOOOOOOOOOO####O
O#OOOOOOOOOOOOOOOOOOOOOOOOOOO#O
O#OOOOOOOOOOOOOOOOOOOOOOOOOOO#O
O#OOOOOOO#############OOOOOOO#O
O#OOOOOOOOOOOOOOOOOOOOOOOOOOO#O
O#OOOOOOOOOOOOOOOOOOOOOOOOOOO#O
O########OOOOOOOOOOOOO########O
OOOOOOOOOOOOOOOOOOOOOOOOOOOOOOO