OOOOOOOOOOOOOOOOOOOOOOOOOOOOOOO
O########OOOOOO#OOOOOO########O
O#OOOOOOOOOOOOO#OOOOOOOOOOOOO#O
O#OOOOOOOOOOOOO#OOOOOOOOOOOOO#O
O#OOOOOOOOOO#######OOOOOOOOOO#O
O#OOOOOOOOOOOOO#OOOOOOOOOOOOO#O
O#OOOOOOOOOOOOO#OOOOOOOOOOOOO#O
O#OOOOOOOOOOOOO#OOOOOOOOOOOOO#O
O#OOOOOOOOOOOOO#OOOOOOOOOOOOO#O
OOOOOOOOOOOOOOOOOOOOOOOOOOOOOOO
OOOOOOOOOOOOOOOOOOOOOOOOOOOOOOO
OOOOOOOOOOOOOOOOOOOOOOOOOOOOOOO
OOOOOOOOOOOOOOO#OOOOOOOOOOOOOOO
O#OOOOOOOOOOOOO#OOOOOOOOOOOOO#O
O#OOOOOOOOOOOOO#OOOOOOOOOOOOO#O
O#OOOOOOOOOOOOO#OOOOOOOOOOOOO#O
O#OOOOOOOOOO#######OOOOOOOOOO#O
O#OOOOOOOOOOOOO#OOOOOOOOOOOOO#O
O#OOOOOOOOOOOOO#OOOOOOOOOOOOO#O
O########OOOOOO#OOOOOO########O
OOOOOOOOOOOOOOOOOOOOOOOOOOOOOOO