OOOOOOOOOOOOOOOOOOOOOOOOOOOOOOO
O#############################O
OOOOOOOOOOOOOOOOOOOOOOOOOOOOO#O
OOOOOOOOOOOOOOOOOOOOOOOOOOOOO#O
OOOOOOOOOOOOOOOOOOOOOOOOOOOOO#O
OOOOO##################OOOOOO#O
OOOOO#OOOOOOOOOOOOOOOO#OOOOOO#O
OOOOO#OOOOOOOOOOOOOOOO#OOOOOO#O
OOOOO#OOOOOOOOOOOOOOOO#OOOOOO#O
OOOOO#OOOOOOOOOOOOOOOO#OOOOOO#O
OOOOO#OOOOOOOOOOOOOOOO#OOOOOO#O
OOOOO#OOOOOOOOOOOOOOOO#OOOOOO#O
OOOOO#OOOOOOOOOOOOOOOO#OOOOOO#O
OOOOO#OOOOOOO##########OOOOOO#O
OOOOO#OOOOOOOOOOOOOOOOOOOOOOO#O
OOOOO#OOOOOOOOOOOOOOOOOOOOOOO#O
OOOOO#OOOOOOOOOOOOOOOOOOOOOOO#O
OOOOO#OOOOOOOOOOOOOOOOOOOOOOO#O
OOOOO#OOOOOOOOOOOOOOOOOOOOOOO#O
OOOOO#########################O
OOOOOOOOOOOOOOOOOOOOOOOOOOOOOOO