OOOOOOOOOOOOOOOOOOOOOOOOOOOOOOO
O#############################O
O#OOOOOOOOOOOOOOOOOOOOOOOOOOO#O
O#OOOOOOOOOOOOOOOOOOOOOOOOOOO#O
O#OOOOOOOOOOOOOOOOOOOOOOOOOOO#O
O#OOOOOOOOOOOOOOOOOOOOOOOOOOO#O
OOOOOOOOOOOOOOOOOOOOOOOOOOOOOOO
O#OOOOOOOOOOOOOOOOOOOOOOOOOOO#O
O#OOOOOOOOOOOOOOOOOOOOOOOOOOO#O
O#OOOOOOOOOOOOOOOOOOOOOOOOOOO#O
O#OOOOOOOOOOOOOOOOOOOOOOOOOOO#O
O#OOOOOOOOOOOOOOOOOOOOOOOOOOO#O
O#OOOOOOOOOOOOOOOOOOOOOOOOOOO#O
O#OOOOOOOOOOOOOOOOOOOOOOOOOOO#O
O#OOOOOOOOOOOOOOOOOOOOOOOOOOO#O
O#OOOOOOOOOOOOOOOOOOOOOOOOOOO#O
O#OOOOOOOOOOOOOOOOOOOOOOOOOOO#O
O#OOOOOOOOOOOOOOOOOOOOOOOOOOO#O
O#OOOOOOOOOOOOOOOOOOOOOOOOOOO#O
O#############################O
OOOOOOOOOOOOOOOOOOOOOOOOOOOOOOO
