OOOOOOOOOOOOOOOOOOOOOOOOOOOOOOO
O#############################O
O#OOOOOOOOOOOOOOOOOOOOOOOOOOO#O
O#OOOOOOOOOOOOOOOOOOOOOOOOOOO#O
O#OOOOOOOOOOOOOOOOOOOOOOOOOOO#O
O#OOOOOOOOOOOOOOOOOOOOOOOOOOO#O
O#OOOOOOOOOOOOOOOOOOOOOOOOOOO#O
O#OOOOOOOOOOOOOOOOOOOOOOOOOOO#O
O#OOOOOOOOOOOOOOOOOOOOOOOOOOO#O
O#OOOOOOOOOOOOOOOOOOOOOOOOOOO#O
O#OOOOOOOOOOOOOOOOOOOOOOOOOOO#O
O#OOOOOOOOOOOOOOOOOOOOOOOOOOOOO
O#OOOOOOOOOOOOOOOOOOOOOOOOOOO#O
O#OOOOOOOOOOOOOOOOOOOOOOOOOOO#O
O#OOOOOOOOOOOOOOOOOOOOOOOOOOO#O
O#OOOOOOOOOOOOOOOOOOOOOOOOOOO#O
O#OOOOOOOOOOOOOOOOOOOOOOOOOOO#O
O#OOOOOOOOOOOOOOOOOOOOOOOOOOO#O
O#OOOOOOOOOOOOOOOOOOOOOOOOOOO#O
O#############################O
OOOOOOOOOOOOOOOOOOOOOOOOOOOOOOO
