OOOOOOOOOOOOOOOOOOOOOOOOOOOOOOO
O########OOOOOO#OOOOOO########O
O#OOOOOOOOOOOOO#OOOOOOOOOOOOO#O
O#OOOOOOOOOOOOO#OOOOOOOOOOOOO#O
O#OOOOOOOOOO#######OOOOOOOOOO#O
O#OOOOOOOOOOOOO#OOOOOOOOOOOOO#O
O#OOOOOOOOOOOOO#OOOOOOOOOOOOO#O
O#OOOOOOOOOOOOOOOOOOOOOOOOOOO#O
O#OOOOOOOOOOOOOOOOOOOOOOOOOOO#O
OOOOOOOOOOOOOOOOOOOOOOOOOOOOOOO
OOOOOOOOOOOOOOOOOOOOOOOOOOOOOOO
OOOOOOOOOOOOOOOOOOOOOOOOOOOOOOO
OOOOOOOOOOOOOOOOOOOOOOOOOOOOOOO
O#OOOOOOOOOOOOOOOOOOOOOOOOOOO#O
O#OOOOOOOOOOOOO#OOOOOOOOOOOOO#O
O#OOOOOOOOOOOOO#OOOOOOOOOOOOO#O
O#OOOOOOOOOO#######OOOOOOOOOO#O
O#OOOOOOOOOOOOO#OOOOOOOOOOOOO#O
O#OOOOOOOOOOOOO#OOOOOOOOOOOOO#O
O########OOOOOO#OOOOOO########O
OOOOOOOOOOOOOOOOOOOOOOOOOOOOOOO