OOOOOOOOOOOOOOOOOOOOOOOOOOOOOOO
O###OOOOOOOOOOOOOOOOOOOOOOO###O
OOOO###OOOOOOOOOOOOOOOOO###OOOO
OOOOOOO###OOOOOOOOOOO###OOOOOOO
OOOOOOOOOO###OOOOO###OOOOOOOOOO
OOOOOOOOOOOOOOOOOOOOOOOOOOOOOOO
OOOOOOOOOOOOOOOOOOOOOOOOOOOOOOO
OOOOOOOOOOOOOOOOOOOOOOOOOOOOOOO
OOOOOOOOOOOOOOOOOOOOOOOOOOOOOOO
OOOOOOOOOOOOOOOOOOOOOOOOOOOOOOO
OOOOOOOOOOOOOOOOOOOOOOOOOOOOOOO
OOOOOOOOOOOOOOOOOOOOOOOOOOOOOOO
OOOOOOOOOOOOOOOOOOOOOOOOOOOOOOO
OOOOOOOOOOOOOOOOOOOOOOOOOOOOOOO
OOOOOOOOOOOOOOOOOOOOOOOOOOOOOOO
OOOOOOOOOOOOOOOOOOOOOOOOOOOOOOO
OOOOOOOOOO###OOOOO###OOOOOOOOOO
OOOOOOO###OOOOOOOOOOO###OOOOOOO
OOOO###OOOOOOOOOOOOOOOOO###OOOO
O###OOOOOOOOOOOOOOOOOOOOOOO###O
OOOOOOOOOOOOOOOOOOOOOOOOOOOOOOO